name,a1,a2,a3,a4,a5,group
x1,149,4,30,2,145,0
x2,133,2,10,15,131,0
x3,82,8,8,2,74,1
x4,102,3,0,9,99,0
x5,162,10,12,11,152,1
x6,128,5,10,6,123,1
x7,423,2,1,8,421,0
x8,123,12,8,3,111,1
x9,145,14,3,8,131,1
x10,73,7,0,5,66,0
